[
	[1, 1, 1, 1, 0, 0, 5, 0, 0, 1, 1, 1, 1, 1, 1, 1, 1, 1, 1, 1],
	[1, 1, 1, 0, 0, 5, 18, 5, 0, 0, 1, 1, 1, 0, 15, 15, 15, 0, 1, 1],
	[1, 1, 0, 0, 5, 0, 0, 1, 5, 0, 0, 1, 1, 0, 15, 17, 15, 0, 0, 1],
	[1, 0, 0, 5, 1, 1, 0, 1, 1, 5, 0, 0, 1, 0, 0, 0, 1, 0, 0, 1],
	[0, 0, 5, 1, 0, 0, 0, 1, 1, 1, 5, 0, 0, 0, 0, 1, 1, 1, 0, 1],
	[0, 5, 1, 1, 0, 1, 1, 1, 0, 1, 1, 5, 0, 0, 0, 0, 1, 0, 0, 1],
	[0, 0, 0, 0, 0, 1, 0, 1, 1, 1, 1, 0, 5, 0, 0, 1, 0, 0, 0, 1],
	[0, 5, 1, 1, 0, 1, 1, 1, 0, 1, 1, 5, 0, 0, 1, 1, 1, 0, 0, 1],
	[0, 0, 5, 1, 1, 1, 0, 1, 1, 1, 5, 0, 0, 0, 0, 1, 0, 0, 0, 1],
	[0, 0, 0, 5, 0, 1, 1, 1, 0, 5, 0, 0, 5, 5, 5, 5, 0, 5, 5, 1],
	[0, 1, 0, 0, 5, 1, 0, 1, 5, 0, 0, 0, 5, 0, 0, 0, 0, 0, 5, 1],
	[1, 1, 1, 0, 0, 5, 0, 5, 0, 0, 0, 0, 0, 0, 5, 5, 5, 0, 5, 1],
	[0, 1, 0, 0, 0, 0, 0, 0, 0, 1, 0, 0, 5, 0, 0, 0, 0, 22, 5, 1],
	[1, 1, 1, 1, 1, 0, 0, 0, 1, 1, 1, 0, 5, 5, 5, 5, 5, 5, 5, 1],
	[1, 1, 1, 1, 1, 1, 1, 0, 0, 1, 0, 0, 1, 1, 1, 1, 1, 1, 1, 1]
]