[
	[5, 5, 5, 5, 5, 5, 5, 5, 5, 5, 5, 0, 0, 0, 0, 10, 10, 10, 10, 10],
	[5, 0, 0, 1, 0, 0, 0, 1, 0, 0, 5, 0, 0, 0, 0, 10, 10, 10, 10, 10],
	[5, 0, 0, 1, 0, 18, 0, 1, 0, 0, 5, 0, 0, 0, 0, 10, 10, 10, 10, 10],
	[5, 0, 0, 1, 0, 0, 0, 1, 0, 0, 5, 0, 0, 0, 0, 10, 10, 10, 10, 10],
	[5, 0, 0, 3, 3, 3, 3, 3, 0, 0, 5, 0, 0, 0, 0, 10, 10, 10, 10, 10],
	[5, 0, 0, 0, 0, 22, 0, 0, 0, 0, 5, 0, 0, 0, 0, 10, 10, 10, 10, 10],
	[5, 0, 0, 0, 0, 0, 0, 0, 0, 0, 5, 0, 0, 0, 0, 10, 10, 10, 10, 10],
	[5, 0, 2, 0, 2, 0, 2, 0, 2, 0, 5, 0, 0, 0, 0, 10, 10, 10, 10, 10],
	[5, 0, 0, 0, 15, 17, 15, 0, 0, 0, 5, 0, 0, 0, 0, 10, 10, 10, 10, 10],
	[5, 5, 5, 5, 5, 5, 5, 5, 5, 5, 5, 0, 0, 0, 0, 10, 10, 10, 10, 10],
	[10, 10, 10, 10, 10, 10, 10, 10, 10, 10, 10, 10, 10, 10, 10, 10, 10, 10, 10, 10],
	[10, 10, 10, 10, 10, 10, 10, 10, 10, 10, 10, 10, 10, 10, 10, 10, 10, 10, 10, 10],
	[10, 10, 10, 10, 10, 10, 10, 10, 10, 10, 10, 10, 10, 10, 10, 10, 10, 10, 10, 10],
	[10, 10, 10, 10, 10, 10, 10, 10, 10, 10, 10, 10, 10, 10, 10, 10, 10, 10, 10, 10],
	[10, 10, 10, 10, 10, 10, 10, 10, 10, 10, 10, 10, 10, 10, 10, 10, 10, 10, 10, 10]
]