[
	[4, 4, 4, 4, 1, 4, 4, 4, 4, 4, 4, 4, 3, 3, 3, 3, 0, 2, 0, 0],
	[4, 4, 4, 1, 18, 1, 4, 4, 4, 4, 4, 4, 4, 4, 4, 4, 3, 0, 0, 0],
	[4, 4, 4, 1, 16, 1, 4, 4, 4, 4, 4, 4, 4, 4, 4, 4, 4, 3, 0, 2],
	[4, 4, 1, 16, 16, 16, 1, 4, 4, 4, 4, 3, 3, 3, 3, 4, 4, 3, 3, 0],
	[4, 4, 1, 0, 0, 0, 1, 4, 4, 4, 4, 1, 4, 4, 3, 4, 4, 4, 3, 3],
	[4, 4, 1, 0, 0, 0, 1, 4, 4, 4, 1, 15, 1, 4, 3, 3, 3, 3, 4, 3],
	[4, 4, 1, 0, 0, 0, 1, 4, 4, 4, 1, 15, 1, 4, 4, 3, 3, 4, 4, 3],
	[4, 4, 1, 0, 0, 0, 0, 0, 0, 0, 0, 15, 1, 4, 4, 3, 4, 4, 4, 3],
	[4, 4, 1, 0, 0, 0, 1, 4, 4, 4, 1, 15, 1, 4, 3, 3, 4, 4, 3, 3],
	[4, 4, 1, 0, 0, 0, 1, 4, 4, 4, 1, 17, 1, 4, 3, 4, 3, 3, 3, 3],
	[4, 4, 1, 0, 0, 0, 1, 4, 4, 4, 4, 1, 4, 4, 3, 4, 3, 3, 4, 3],
	[4, 4, 1, 0, 0, 0, 1, 4, 3, 3, 4, 4, 4, 4, 3, 3, 4, 4, 4, 3],
	[4, 4, 4, 1, 0, 1, 4, 4, 3, 3, 4, 3, 4, 4, 4, 3, 3, 3, 3, 3],
	[4, 4, 4, 1, 0, 1, 4, 4, 3, 4, 4, 4, 3, 4, 4, 4, 4, 4, 4, 4],
	[4, 4, 4, 4, 1, 4, 4, 4, 4, 3, 3, 3, 3, 3, 4, 4, 4, 4, 4, 4]
]