[
	[9, 9, 9, 5, 5, 5, 5, 5, 9, 9, 9, 9, 5, 5, 5, 5, 5, 9, 9, 9],
	[9, 9, 9, 5, 15, 17, 15, 5, 9, 9, 9, 9, 5, 15, 15, 15, 5, 9, 9, 9],
	[9, 9, 9, 5, 0, 0, 0, 5, 9, 9, 9, 9, 5, 0, 0, 0, 5, 9, 9, 9],
	[9, 9, 9, 5, 0, 0, 0, 5, 9, 9, 9, 9, 5, 0, 0, 0, 5, 9, 9, 9],
	[9, 9, 9, 5, 5, 0, 5, 5, 9, 9, 9, 9, 5, 5, 0, 5, 5, 9, 9, 9],
	[9, 9, 9, 5, 0, 0, 0, 5, 9, 9, 9, 9, 5, 0, 0, 0, 5, 9, 9, 9],
	[9, 9, 9, 5, 0, 0, 0, 5, 9, 9, 9, 9, 5, 0, 0, 0, 5, 9, 9, 9],
	[9, 9, 9, 5, 5, 0, 5, 5, 9, 9, 9, 9, 5, 5, 0, 5, 5, 9, 9, 9],
	[9, 9, 9, 5, 0, 0, 0, 5, 9, 9, 9, 9, 5, 0, 0, 0, 5, 9, 9, 9],
	[9, 9, 9, 5, 0, 0, 0, 5, 9, 9, 9, 9, 5, 0, 0, 0, 5, 9, 9, 9],
	[9, 9, 9, 5, 5, 0, 5, 5, 9, 9, 9, 9, 5, 5, 0, 5, 5, 9, 9, 9],
	[9, 9, 9, 5, 0, 0, 0, 5, 9, 9, 9, 9, 5, 0, 0, 0, 5, 9, 9, 9],
	[9, 9, 9, 5, 0, 0, 0, 5, 9, 9, 9, 9, 5, 0, 0, 0, 5, 9, 9, 9],
	[9, 9, 9, 5, 5, 0, 5, 5, 9, 9, 9, 9, 5, 5, 18, 5, 5, 9, 9, 9],
	[9, 9, 9, 5, 5, 5, 5, 5, 9, 9, 9, 9, 5, 5, 5, 5, 5, 9, 9, 9]
]