[
	[2, 2, 2, 2, 2, 2, 2, 2, 2, 2, 2, 2, 2, 2, 2, 2, 2, 2, 2, 2],
	[2, 2, 2, 2, 2, 2, 2, 2, 2, 2, 2, 2, 2, 2, 2, 2, 2, 2, 2, 2],
	[2, 2, 2, 0, 0, 0, 2, 0, 0, 2, 0, 0, 0, 0, 0, 0, 0, 2, 2, 2],
	[2, 2, 2, 0, 18, 0, 0, 0, 0, 0, 0, 2, 0, 2, 0, 2, 0, 2, 2, 2],
	[2, 2, 2, 16, 16, 16, 2, 0, 0, 2, 0, 0, 0, 0, 0, 0, 0, 2, 2, 2],
	[2, 2, 2, 0, 16, 0, 2, 2, 2, 2, 2, 2, 0, 2, 0, 2, 0, 2, 2, 2],
	[2, 2, 2, 0, 0, 0, 0, 0, 2, 0, 15, 0, 0, 0, 0, 0, 0, 2, 2, 2],
	[2, 2, 2, 0, 3, 3, 3, 0, 2, 15, 17, 15, 0, 2, 0, 2, 0, 2, 2, 2],
	[2, 2, 2, 0, 3, 22, 3, 0, 2, 0, 15, 0, 0, 0, 0, 0, 0, 2, 2, 2],
	[2, 2, 2, 0, 3, 3, 3, 0, 2, 2, 2, 2, 0, 2, 2, 0, 0, 2, 2, 2],
	[2, 2, 2, 0, 0, 0, 0, 0, 0, 0, 0, 2, 2, 2, 0, 0, 0, 2, 2, 2],
	[2, 2, 2, 0, 2, 2, 2, 2, 2, 2, 0, 0, 0, 0, 0, 2, 0, 2, 2, 2],
	[2, 2, 2, 0, 0, 0, 0, 0, 0, 0, 0, 0, 0, 0, 0, 0, 0, 2, 2, 2],
	[2, 2, 2, 2, 2, 2, 2, 2, 2, 2, 2, 2, 2, 2, 2, 2, 2, 2, 2, 2],
	[2, 2, 2, 2, 2, 2, 2, 2, 2, 2, 2, 2, 2, 2, 2, 2, 2, 2, 2, 2]
]