[
	[3, 3, 3, 3, 3, 3, 3, 3, 3, 3, 3, 3, 3, 3, 3, 3, 3, 3, 3, 3],
	[3, 0, 4, 4, 4, 4, 4, 4, 4, 4, 4, 4, 4, 4, 4, 4, 4, 0, 0, 3],
	[3, 15, 6, 0, 6, 0, 6, 0, 6, 0, 6, 0, 6, 0, 6, 0, 4, 0, 0, 3],
	[3, 15, 0, 6, 0, 6, 0, 6, 0, 6, 0, 6, 0, 6, 0, 6, 4, 0, 0, 3],
	[3, 0, 4, 4, 4, 4, 4, 4, 4, 4, 4, 4, 4, 4, 6, 0, 4, 0, 0, 3],
	[3, 0, 4, 6, 0, 6, 0, 6, 0, 6, 0, 6, 0, 4, 0, 6, 4, 0, 0, 3],
	[3, 0, 4, 0, 6, 0, 6, 0, 6, 6, 6, 0, 6, 4, 6, 0, 4, 0, 0, 3],
	[3, 0, 4, 6, 0, 4, 4, 4, 6, 18, 6, 4, 4, 4, 0, 6, 4, 0, 17, 3],
	[3, 0, 4, 0, 6, 4, 6, 0, 6, 6, 6, 0, 6, 0, 6, 0, 4, 0, 0, 3],
	[3, 0, 4, 6, 0, 4, 0, 6, 0, 6, 0, 6, 0, 6, 0, 6, 4, 0, 0, 3],
	[3, 0, 4, 0, 6, 4, 4, 4, 4, 4, 4, 4, 4, 4, 4, 4, 4, 0, 0, 3],
	[3, 0, 4, 6, 0, 6, 0, 6, 0, 6, 0, 6, 0, 6, 0, 6, 0, 15, 0, 3],
	[3, 0, 4, 0, 6, 0, 6, 0, 6, 0, 6, 0, 6, 0, 6, 0, 6, 15, 0, 3],
	[3, 0, 4, 4, 4, 4, 4, 4, 4, 4, 4, 4, 4, 4, 4, 4, 4, 0, 0, 3],
	[3, 3, 3, 3, 3, 3, 3, 3, 3, 3, 3, 3, 3, 3, 3, 3, 3, 3, 3, 3]
]