[
	[7, 7, 7, 7, 7, 7, 7, 7, 7, 5, 7, 7, 7, 7, 7, 7, 7, 7, 7, 7],
	[7, 7, 7, 7, 7, 7, 7, 7, 5, 7, 5, 7, 7, 7, 7, 7, 7, 7, 7, 7],
	[7, 7, 7, 7, 7, 7, 7, 5, 7, 0, 7, 5, 7, 7, 7, 7, 7, 7, 7, 7],
	[7, 7, 7, 7, 7, 7, 5, 7, 5, 22, 5, 7, 5, 7, 7, 7, 7, 7, 7, 7],
	[7, 7, 7, 7, 7, 5, 7, 16, 5, 0, 5, 16, 7, 5, 7, 7, 7, 7, 7, 7],
	[7, 7, 7, 7, 5, 7, 16, 5, 0, 0, 0, 5, 16, 7, 5, 7, 7, 7, 7, 7],
	[7, 7, 7, 5, 7, 0, 0, 5, 0, 18, 0, 5, 0, 0, 7, 5, 7, 7, 7, 7],
	[7, 7, 5, 7, 0, 25, 0, 5, 0, 0, 0, 5, 0, 25, 0, 7, 5, 7, 7, 7],
	[7, 7, 7, 5, 7, 0, 5, 0, 5, 0, 5, 0, 5, 0, 7, 5, 7, 7, 7, 7],
	[7, 7, 7, 7, 5, 7, 0, 5, 0, 0, 0, 5, 0, 7, 5, 7, 7, 7, 7, 7],
	[7, 7, 7, 7, 7, 5, 7, 0, 15, 0, 15, 0, 7, 5, 7, 7, 7, 7, 7, 7],
	[7, 7, 7, 7, 7, 7, 5, 7, 15, 0, 15, 7, 5, 7, 7, 7, 7, 7, 7, 7],
	[7, 7, 7, 7, 7, 7, 7, 5, 7, 17, 7, 5, 7, 7, 7, 7, 7, 7, 7, 7],
	[7, 7, 7, 7, 7, 7, 7, 7, 5, 7, 5, 7, 7, 7, 7, 7, 7, 7, 7, 7],
	[7, 7, 7, 7, 7, 7, 7, 7, 7, 5, 7, 7, 7, 7, 7, 7, 7, 7, 7, 7]
]