[
	[2, 2, 2, 2, 2, 2, 2, 2, 2, 2, 2, 2, 2, 2, 2, 2, 2, 2, 2, 2],
	[2, 0, 0, 0, 7, 0, 0, 0, 7, 7, 0, 7, 0, 0, 0, 7, 7, 7, 0, 0],
	[7, 7, 7, 0, 7, 0, 2, 0, 7, 0, 0, 7, 0, 2, 0, 0, 0, 0, 0, 0],
	[7, 0, 0, 0, 0, 0, 0, 0, 7, 7, 7, 7, 0, 0, 0, 0, 7, 0, 0, 0],
	[0, 0, 7, 7, 7, 0, 0, 7, 7, 7, 0, 7, 0, 0, 0, 7, 7, 7, 2, 0],
	[7, 7, 7, 0, 7, 7, 7, 7, 0, 7, 0, 7, 7, 7, 7, 7, 7, 7, 2, 0],
	[15, 15, 0, 7, 0, 7, 0, 0, 0, 7, 0, 7, 0, 7, 7, 0, 7, 0, 2, 16],
	[0, 17, 0, 7, 7, 0, 0, 7, 7, 0, 22, 0, 0, 7, 0, 0, 0, 16, 16, 18],
	[15, 15, 0, 7, 0, 7, 0, 0, 0, 7, 0, 7, 0, 7, 7, 0, 7, 0, 2, 16],
	[7, 7, 7, 0, 7, 7, 7, 7, 0, 7, 0, 7, 7, 7, 7, 7, 7, 7, 2, 0],
	[0, 0, 7, 7, 7, 0, 0, 7, 7, 7, 0, 7, 0, 0, 0, 7, 7, 7, 2, 0],
	[7, 0, 0, 0, 0, 0, 0, 0, 7, 7, 7, 7, 0, 0, 0, 0, 7, 0, 0, 0],
	[7, 7, 7, 0, 7, 0, 2, 0, 7, 0, 0, 7, 0, 2, 0, 0, 0, 0, 0, 0],
	[2, 0, 0, 0, 7, 0, 0, 0, 7, 7, 0, 7, 0, 0, 0, 7, 7, 7, 0, 0],
	[2, 2, 2, 2, 2, 2, 2, 2, 2, 2, 2, 2, 2, 2, 2, 2, 2, 2, 2, 2]
]