[
	[0, 5, 0, 0, 5, 0, 5, 0, 5, 5, 5, 0, 0, 5, 0, 0, 0, 5, 0, 0],
	[0, 5, 0, 15, 5, 0, 5, 0, 5, 0, 5, 0, 0, 5, 0, 5, 0, 5, 0, 0],
	[0, 5, 0, 0, 5, 0, 5, 0, 0, 0, 0, 0, 0, 0, 0, 5, 0, 0, 5, 0],
	[0, 5, 0, 0, 5, 0, 5, 0, 16, 0, 16, 0, 0, 0, 0, 5, 0, 5, 0, 0],
	[0, 5, 0, 0, 5, 18, 5, 5, 5, 5, 5, 5, 5, 5, 0, 5, 0, 5, 0, 0],
	[0, 5, 5, 0, 5, 5, 5, 0, 0, 0, 0, 0, 0, 5, 5, 0, 0, 5, 0, 0],
	[0, 0, 5, 0, 5, 0, 0, 0, 0, 5, 5, 0, 0, 5, 0, 5, 0, 5, 0, 0],
	[0, 0, 5, 0, 0, 0, 5, 0, 0, 8, 6, 0, 0, 5, 0, 0, 0, 5, 0, 0],
	[0, 0, 5, 0, 5, 0, 5, 0, 0, 5, 5, 0, 0, 0, 0, 5, 0, 5, 0, 0],
	[0, 0, 5, 0, 0, 5, 5, 0, 0, 0, 0, 0, 0, 5, 5, 5, 0, 5, 5, 0],
	[0, 0, 5, 0, 5, 0, 5, 5, 5, 5, 5, 5, 5, 5, 17, 5, 0, 0, 5, 0],
	[0, 0, 5, 0, 5, 0, 0, 0, 0, 16, 0, 16, 0, 5, 0, 5, 0, 0, 5, 0],
	[0, 5, 0, 0, 5, 0, 5, 0, 0, 0, 0, 0, 0, 5, 0, 5, 0, 0, 5, 0],
	[0, 0, 5, 0, 5, 0, 5, 0, 0, 5, 0, 5, 0, 5, 0, 5, 15, 15, 5, 0],
	[0, 0, 5, 0, 0, 0, 5, 0, 0, 5, 5, 5, 0, 5, 0, 5, 15, 15, 5, 0]
]