[
	[5, 5, 5, 5, 5, 5, 5, 5, 5, 5, 5, 5, 5, 5, 5, 5, 5, 5, 5, 5],
	[5, 0, 0, 0, 0, 1, 0, 1, 0, 1, 0, 0, 0, 0, 0, 25, 0, 0, 0, 0],
	[5, 0, 0, 0, 5, 5, 5, 5, 5, 5, 0, 0, 0, 0, 0, 0, 0, 15, 15, 0],
	[5, 0, 0, 0, 7, 7, 22, 7, 7, 5, 0, 0, 0, 0, 0, 0, 15, 17, 0, 0],
	[5, 0, 0, 0, 5, 7, 0, 0, 7, 5, 7, 0, 7, 7, 7, 7, 0, 15, 15, 0],
	[5, 0, 16, 0, 5, 7, 7, 0, 0, 0, 7, 0, 7, 7, 7, 5, 5, 5, 0, 25],
	[5, 16, 18, 16, 5, 5, 5, 5, 7, 7, 7, 0, 7, 7, 0, 0, 7, 5, 0, 0],
	[5, 0, 16, 0, 0, 0, 0, 0, 7, 0, 7, 0, 7, 0, 0, 7, 7, 5, 0, 0],
	[5, 0, 0, 0, 0, 0, 7, 7, 7, 0, 7, 7, 5, 0, 7, 7, 0, 5, 0, 0],
	[5, 0, 5, 5, 5, 5, 7, 5, 7, 0, 7, 0, 5, 5, 5, 5, 5, 5, 0, 0],
	[5, 0, 7, 25, 0, 0, 0, 5, 7, 0, 0, 0, 0, 0, 0, 0, 0, 0, 7, 0],
	[5, 0, 5, 0, 0, 0, 0, 5, 0, 0, 0, 1, 1, 1, 1, 1, 0, 7, 7, 7],
	[5, 0, 5, 0, 0, 0, 0, 0, 1, 1, 1, 1, 1, 0, 0, 0, 7, 7, 7, 7],
	[5, 0, 5, 5, 5, 1, 1, 1, 1, 1, 0, 0, 0, 0, 0, 7, 7, 7, 0, 7],
	[5, 0, 0, 0, 0, 0, 0, 0, 0, 0, 0, 0, 0, 0, 0, 0, 7, 7, 7, 7]
]