[
	[5, 5, 5, 5, 5, 5, 5, 5, 8, 8, 8, 8, 8, 8, 8, 8, 8, 8, 8, 8],
	[5, 5, 5, 5, 0, 22, 0, 5, 5, 5, 5, 5, 5, 5, 5, 5, 5, 5, 5, 8],
	[5, 0, 0, 0, 0, 0, 0, 0, 0, 5, 0, 0, 0, 0, 0, 0, 0, 0, 5, 8],
	[5, 0, 0, 0, 5, 5, 5, 0, 0, 0, 0, 0, 5, 5, 5, 5, 5, 0, 5, 8],
	[5, 0, 5, 5, 5, 8, 5, 5, 0, 25, 0, 5, 5, 8, 8, 8, 5, 0, 5, 8],
	[8, 8, 8, 8, 8, 5, 5, 0, 0, 0, 0, 0, 5, 8, 8, 8, 5, 0, 5, 8],
	[0, 0, 0, 0, 8, 5, 0, 0, 5, 5, 5, 0, 5, 8, 8, 8, 5, 0, 5, 5],
	[0, 0, 0, 16, 8, 5, 0, 0, 5, 8, 5, 0, 5, 8, 5, 5, 5, 15, 5, 0],
	[18, 9, 16, 16, 8, 0, 0, 0, 5, 8, 5, 0, 5, 8, 5, 0, 15, 15, 15, 17],
	[0, 0, 0, 16, 8, 5, 0, 5, 5, 8, 5, 0, 5, 8, 5, 0, 5, 5, 5, 15],
	[0, 0, 0, 0, 8, 5, 0, 5, 8, 8, 5, 0, 5, 5, 5, 0, 5, 8, 5, 5],
	[8, 8, 8, 8, 8, 5, 0, 5, 8, 8, 5, 0, 0, 0, 0, 0, 5, 8, 8, 8],
	[5, 5, 5, 5, 5, 5, 0, 5, 5, 8, 5, 5, 0, 0, 0, 5, 5, 8, 8, 8],
	[8, 8, 8, 8, 8, 5, 0, 22, 5, 8, 8, 5, 5, 5, 5, 5, 8, 8, 8, 8],
	[8, 8, 8, 8, 8, 5, 5, 5, 5, 8, 8, 8, 8, 8, 8, 8, 8, 8, 8, 8]
]