[
	[0, 0, 0, 0, 0, 0, 0, 0, 0, 0, 0, 0, 0, 0, 0, 0, 0, 0, 0, 0],
	[0, 0, 0, 5, 5, 5, 5, 5, 5, 5, 5, 5, 5, 5, 5, 5, 5, 5, 0, 0],
	[0, 0, 0, 5, 0, 0, 0, 0, 0, 0, 0, 0, 0, 0, 0, 0, 0, 5, 0, 0],
	[0, 0, 0, 5, 0, 0, 0, 0, 0, 0, 0, 0, 0, 0, 0, 0, 0, 5, 0, 0],
	[0, 0, 0, 5, 0, 0, 3, 3, 3, 1, 3, 3, 3, 0, 0, 0, 0, 5, 0, 0],
	[0, 0, 0, 5, 0, 0, 3, 2, 0, 0, 2, 2, 3, 0, 0, 1, 0, 5, 0, 0],
	[0, 0, 0, 5, 0, 0, 3, 2, 0, 0, 0, 0, 3, 0, 1, 0, 1, 5, 0, 0],
	[0, 0, 0, 5, 0, 0, 3, 0, 15, 17, 15, 0, 0, 3, 0, 22, 0, 5, 0, 0],
	[0, 0, 0, 5, 0, 0, 3, 0, 0, 0, 0, 2, 3, 0, 1, 0, 1, 5, 0, 0],
	[0, 0, 0, 5, 0, 0, 3, 2, 2, 0, 0, 2, 3, 0, 0, 1, 0, 5, 0, 0],
	[0, 0, 0, 5, 0, 0, 3, 3, 3, 1, 3, 3, 3, 0, 0, 0, 0, 5, 0, 0],
	[0, 0, 0, 5, 0, 0, 0, 0, 0, 0, 0, 0, 0, 0, 0, 18, 0, 5, 0, 0],
	[0, 0, 0, 5, 0, 0, 0, 0, 0, 0, 0, 0, 0, 0, 0, 0, 0, 5, 0, 0],
	[0, 0, 0, 5, 5, 5, 5, 5, 5, 5, 5, 5, 5, 5, 5, 5, 5, 5, 0, 0],
	[0, 0, 0, 0, 0, 0, 0, 0, 0, 0, 0, 0, 0, 0, 0, 0, 0, 0, 0, 0]
]