[
	[5, 5, 5, 5, 5, 5, 5, 5, 5, 5, 5, 5, 5, 5, 5, 5, 5, 5, 5, 5],
	[15, 17, 15, 5, 0, 0, 0, 0, 16, 18, 16, 0, 0, 0, 0, 5, 0, 0, 0, 5],
	[15, 15, 15, 5, 0, 0, 0, 0, 16, 16, 16, 0, 0, 0, 0, 5, 0, 0, 0, 5],
	[0, 5, 1, 5, 0, 0, 0, 0, 0, 0, 0, 0, 0, 0, 0, 0, 0, 0, 0, 5],
	[0, 0, 1, 5, 0, 0, 0, 0, 0, 0, 0, 0, 0, 0, 0, 5, 1, 0, 0, 5],
	[0, 0, 0, 5, 0, 0, 0, 0, 0, 0, 0, 0, 0, 0, 0, 5, 1, 5, 0, 5],
	[1, 0, 0, 5, 5, 5, 5, 5, 0, 5, 0, 5, 5, 5, 5, 5, 1, 0, 0, 5],
	[1, 5, 0, 5, 0, 0, 0, 5, 0, 5, 0, 5, 0, 0, 0, 5, 0, 0, 1, 5],
	[1, 0, 0, 5, 0, 5, 0, 5, 0, 5, 0, 5, 0, 5, 0, 5, 0, 5, 1, 5],
	[0, 0, 0, 5, 0, 5, 0, 5, 0, 5, 0, 5, 0, 5, 0, 5, 0, 0, 1, 5],
	[0, 0, 1, 5, 0, 5, 0, 5, 0, 5, 0, 5, 0, 5, 0, 5, 1, 0, 0, 5],
	[0, 5, 1, 5, 0, 5, 5, 5, 0, 5, 0, 5, 5, 5, 0, 5, 1, 5, 0, 5],
	[0, 0, 1, 0, 0, 0, 0, 0, 0, 0, 0, 0, 0, 0, 0, 0, 1, 0, 0, 5],
	[0, 0, 0, 0, 0, 0, 0, 0, 0, 0, 0, 0, 0, 0, 0, 0, 0, 0, 0, 5],
	[5, 5, 5, 5, 5, 5, 5, 5, 5, 5, 5, 5, 5, 5, 5, 5, 5, 5, 5, 5]
]