[
	[6, 6, 0, 6, 6, 0, 6, 6, 5, 5, 5, 5, 5, 6, 6, 6, 6, 6, 6, 6],
	[6, 6, 0, 6, 6, 0, 6, 5, 5, 0, 0, 0, 5, 6, 6, 6, 6, 6, 6, 6],
	[0, 0, 0, 0, 0, 0, 0, 0, 0, 0, 17, 0, 0, 6, 6, 6, 6, 6, 6, 6],
	[6, 6, 0, 6, 6, 0, 6, 5, 5, 0, 0, 0, 5, 6, 6, 6, 6, 6, 6, 6],
	[6, 6, 0, 6, 6, 0, 6, 6, 5, 5, 5, 5, 5, 6, 6, 6, 6, 6, 6, 6],
	[0, 0, 0, 0, 0, 0, 0, 0, 0, 6, 4, 3, 0, 6, 6, 6, 6, 6, 6, 6],
	[6, 6, 0, 6, 6, 0, 6, 6, 0, 3, 4, 3, 0, 6, 6, 6, 6, 6, 6, 6],
	[6, 6, 0, 6, 6, 0, 6, 6, 0, 3, 4, 3, 0, 6, 6, 6, 15, 6, 6, 6],
	[0, 0, 0, 0, 0, 0, 0, 0, 0, 3, 4, 3, 0, 6, 6, 15, 15, 15, 6, 6],
	[6, 6, 16, 6, 6, 0, 6, 6, 0, 3, 4, 3, 0, 6, 6, 6, 15, 6, 6, 6],
	[6, 6, 6, 6, 6, 0, 6, 6, 0, 3, 4, 3, 0, 6, 6, 6, 6, 6, 6, 6],
	[16, 6, 18, 6, 16, 0, 0, 0, 0, 3, 4, 3, 0, 6, 6, 6, 6, 6, 6, 6],
	[6, 6, 6, 6, 6, 0, 6, 6, 0, 3, 4, 3, 0, 6, 6, 6, 6, 6, 6, 6],
	[6, 6, 16, 6, 6, 0, 6, 6, 0, 3, 4, 3, 0, 6, 6, 6, 6, 6, 6, 6],
	[0, 0, 0, 0, 0, 0, 0, 0, 0, 3, 4, 3, 0, 6, 6, 6, 6, 6, 6, 6]
]