[
	[1, 0, 0, 0, 0, 0, 0, 0, 1, 1, 1, 1, 1, 1, 1, 1, 1, 1, 1, 1],
	[1, 0, 0, 0, 0, 0, 0, 0, 2, 2, 2, 2, 2, 2, 2, 2, 2, 2, 1, 1],
	[1, 0, 1, 1, 2, 0, 0, 0, 0, 0, 0, 0, 0, 0, 0, 16, 16, 2, 1, 1],
	[1, 0, 1, 1, 2, 0, 0, 0, 0, 0, 0, 0, 0, 0, 0, 16, 16, 2, 1, 1],
	[0, 15, 15, 1, 2, 0, 2, 2, 2, 2, 2, 2, 2, 2, 2, 2, 0, 2, 1, 1],
	[0, 17, 0, 1, 2, 3, 2, 3, 3, 3, 3, 3, 3, 3, 3, 2, 0, 0, 2, 1],
	[15, 15, 0, 1, 2, 3, 2, 3, 3, 3, 3, 3, 3, 3, 3, 1, 0, 0, 2, 1],
	[1, 0, 1, 1, 2, 0, 2, 2, 2, 2, 2, 2, 2, 3, 3, 1, 0, 0, 2, 1],
	[1, 1, 1, 1, 2, 0, 0, 0, 0, 16, 16, 0, 2, 3, 3, 1, 0, 0, 2, 1],
	[1, 0, 1, 1, 2, 0, 0, 0, 0, 16, 16, 0, 2, 3, 3, 2, 0, 0, 2, 1],
	[1, 0, 1, 1, 2, 2, 2, 0, 2, 2, 2, 0, 2, 3, 3, 2, 0, 2, 1, 1],
	[1, 1, 1, 1, 1, 1, 1, 0, 0, 0, 0, 0, 2, 1, 1, 2, 0, 2, 1, 1],
	[1, 0, 1, 1, 1, 1, 1, 0, 1, 1, 1, 0, 0, 0, 0, 0, 0, 1, 1, 1],
	[1, 0, 0, 0, 0, 0, 0, 0, 1, 25, 1, 0, 0, 18, 0, 0, 0, 1, 22, 1],
	[1, 1, 1, 1, 1, 1, 1, 1, 1, 1, 1, 0, 0, 0, 0, 0, 0, 1, 1, 1]
]