[
	[0, 2, 0, 2, 0, 2, 0, 0, 3, 4, 3, 0, 0, 0, 0, 0, 18, 0, 0, 0],
	[0, 0, 0, 0, 0, 0, 0, 0, 3, 4, 3, 0, 0, 0, 0, 0, 0, 0, 0, 0],
	[0, 0, 0, 0, 0, 2, 0, 0, 3, 4, 3, 0, 0, 0, 16, 16, 16, 16, 16, 0],
	[0, 15, 17, 15, 0, 0, 0, 0, 3, 4, 3, 0, 0, 0, 0, 0, 0, 0, 0, 0],
	[0, 15, 0, 15, 0, 2, 0, 0, 3, 4, 3, 0, 0, 0, 5, 5, 5, 0, 0, 0],
	[0, 0, 0, 0, 0, 0, 0, 0, 3, 4, 3, 1, 1, 1, 5, 0, 5, 0, 0, 0],
	[0, 2, 0, 2, 0, 2, 0, 0, 3, 4, 3, 0, 0, 0, 5, 0, 5, 0, 0, 0],
	[0, 0, 0, 0, 0, 0, 0, 0, 3, 4, 3, 1, 1, 1, 5, 0, 5, 0, 0, 0],
	[1, 1, 1, 1, 1, 0, 0, 0, 3, 4, 3, 0, 0, 0, 5, 0, 5, 5, 0, 0],
	[1, 1, 1, 1, 1, 0, 0, 0, 3, 4, 3, 1, 1, 1, 5, 0, 0, 5, 0, 0],
	[0, 0, 1, 1, 1, 1, 0, 0, 0, 0, 0, 0, 0, 0, 5, 5, 5, 5, 0, 0],
	[0, 0, 1, 1, 1, 1, 0, 0, 3, 4, 3, 0, 0, 0, 0, 0, 0, 0, 0, 0],
	[0, 0, 1, 1, 1, 1, 1, 0, 3, 4, 3, 0, 0, 0, 0, 0, 0, 0, 0, 0],
	[0, 0, 1, 1, 1, 1, 1, 0, 3, 4, 3, 0, 0, 2, 0, 2, 0, 2, 0, 0],
	[0, 0, 0, 0, 0, 0, 0, 0, 3, 4, 3, 0, 0, 0, 0, 0, 0, 0, 0, 0]
]