[
	[0, 0, 0, 0, 0, 0, 0, 16, 16, 16, 0, 0, 0, 0, 1, 0, 1, 0, 1, 0],
	[0, 0, 0, 0, 0, 0, 0, 0, 0, 0, 0, 0, 0, 0, 5, 5, 5, 5, 5, 1],
	[0, 0, 0, 0, 5, 5, 5, 5, 0, 5, 5, 5, 5, 0, 0, 0, 0, 0, 5, 0],
	[0, 0, 0, 0, 5, 0, 0, 0, 0, 0, 0, 0, 5, 0, 0, 0, 0, 0, 5, 1],
	[0, 0, 0, 0, 5, 0, 0, 0, 15, 0, 0, 0, 5, 0, 0, 0, 0, 0, 5, 0],
	[0, 0, 16, 0, 5, 0, 0, 0, 0, 0, 0, 0, 5, 0, 16, 0, 0, 0, 5, 1],
	[0, 0, 16, 0, 0, 0, 15, 0, 17, 0, 15, 0, 0, 0, 16, 0, 0, 0, 0, 0],
	[0, 0, 16, 0, 5, 0, 0, 0, 0, 0, 0, 0, 5, 0, 16, 0, 0, 0, 0, 0],
	[0, 0, 0, 0, 5, 0, 0, 0, 15, 0, 0, 0, 5, 9, 9, 9, 9, 9, 9, 9],
	[0, 0, 0, 0, 5, 0, 0, 0, 0, 0, 0, 0, 5, 9, 0, 0, 0, 0, 0, 0],
	[0, 0, 0, 0, 5, 5, 5, 5, 0, 5, 5, 5, 5, 9, 0, 9, 9, 9, 9, 9],
	[1, 1, 1, 1, 0, 0, 0, 0, 0, 0, 0, 0, 0, 9, 0, 9, 0, 0, 0, 9],
	[0, 0, 0, 1, 0, 0, 0, 16, 16, 16, 0, 0, 0, 9, 0, 9, 0, 18, 0, 9],
	[0, 0, 0, 1, 0, 0, 0, 0, 0, 0, 0, 0, 0, 9, 0, 9, 0, 0, 0, 9],
	[0, 0, 0, 1, 0, 0, 0, 0, 0, 0, 0, 0, 0, 9, 0, 9, 9, 9, 9, 9]
]