[
	[9, 9, 9, 5, 5, 0, 0, 16, 16, 18, 16, 16, 0, 0, 5, 5, 9, 9, 9, 9],
	[9, 5, 5, 25, 5, 0, 5, 0, 0, 25, 0, 0, 5, 0, 5, 25, 5, 5, 9, 9],
	[5, 0, 0, 0, 5, 0, 0, 0, 0, 0, 0, 0, 0, 0, 5, 0, 0, 0, 5, 9],
	[5, 0, 0, 0, 5, 5, 5, 5, 0, 0, 0, 5, 5, 5, 5, 0, 0, 0, 5, 9],
	[5, 0, 5, 0, 0, 0, 25, 5, 0, 0, 0, 5, 25, 0, 0, 0, 5, 0, 5, 9],
	[5, 0, 0, 0, 0, 0, 0, 0, 0, 0, 0, 0, 0, 0, 0, 0, 0, 0, 5, 9],
	[9, 9, 0, 9, 9, 9, 0, 0, 0, 25, 0, 0, 0, 9, 9, 9, 0, 9, 9, 9],
	[9, 9, 0, 9, 9, 9, 9, 0, 1, 1, 1, 0, 9, 9, 9, 9, 0, 9, 9, 9],
	[9, 9, 25, 9, 9, 9, 9, 9, 0, 1, 0, 9, 9, 9, 9, 9, 25, 9, 9, 9],
	[9, 9, 9, 0, 9, 9, 9, 9, 9, 0, 9, 9, 9, 9, 9, 0, 9, 9, 9, 9],
	[9, 0, 0, 9, 9, 9, 9, 9, 9, 9, 9, 9, 9, 9, 9, 9, 0, 0, 9, 9],
	[9, 9, 0, 9, 9, 9, 9, 9, 9, 9, 9, 9, 9, 9, 9, 9, 0, 9, 9, 9],
	[9, 9, 0, 9, 9, 9, 9, 9, 9, 0, 9, 9, 9, 9, 9, 9, 0, 9, 9, 9],
	[5, 0, 0, 0, 5, 0, 0, 0, 0, 15, 0, 0, 0, 0, 5, 0, 0, 0, 5, 9],
	[5, 0, 15, 0, 0, 15, 0, 0, 0, 17, 0, 0, 0, 15, 0, 0, 15, 0, 5, 9]
]