[
	[0, 0, 0, 0, 0, 0, 0, 0, 0, 0, 0, 0, 0, 0, 0, 0, 9, 9, 9, 9],
	[0, 0, 0, 0, 0, 0, 0, 0, 0, 0, 0, 0, 0, 0, 0, 0, 0, 9, 9, 9],
	[0, 1, 1, 5, 5, 5, 5, 5, 5, 5, 5, 5, 1, 1, 5, 0, 0, 9, 9, 9],
	[0, 0, 0, 5, 0, 0, 0, 0, 1, 0, 9, 5, 0, 0, 5, 0, 0, 0, 9, 9],
	[0, 0, 0, 5, 0, 0, 16, 0, 1, 0, 9, 5, 1, 1, 5, 0, 2, 0, 9, 9],
	[0, 0, 0, 5, 0, 16, 18, 16, 1, 0, 9, 5, 0, 0, 5, 0, 0, 0, 9, 9],
	[0, 0, 0, 5, 0, 0, 16, 0, 1, 0, 9, 9, 9, 9, 5, 0, 0, 0, 9, 9],
	[0, 15, 0, 5, 1, 1, 1, 1, 0, 0, 9, 0, 0, 0, 5, 0, 22, 0, 9, 9],
	[15, 17, 15, 5, 0, 0, 0, 0, 0, 9, 9, 0, 0, 0, 5, 0, 0, 0, 9, 9],
	[0, 15, 0, 5, 9, 9, 9, 9, 9, 9, 9, 0, 0, 0, 5, 0, 0, 0, 9, 9],
	[0, 15, 0, 5, 9, 9, 0, 0, 0, 0, 9, 0, 0, 0, 5, 0, 2, 0, 9, 9],
	[0, 0, 0, 5, 9, 9, 9, 9, 9, 9, 9, 9, 9, 9, 5, 0, 0, 0, 9, 9],
	[0, 0, 0, 5, 9, 9, 5, 5, 0, 0, 5, 5, 5, 5, 5, 0, 0, 9, 9, 9],
	[0, 0, 9, 9, 9, 9, 22, 0, 0, 0, 0, 0, 0, 0, 0, 0, 0, 9, 9, 9],
	[0, 9, 9, 9, 9, 9, 0, 0, 0, 0, 0, 0, 0, 0, 0, 0, 9, 9, 9, 9]
]