[
	[4, 4, 4, 4, 4, 4, 4, 4, 4, 4, 4, 4, 4, 4, 5, 0, 0, 0, 0, 0],
	[4, 4, 4, 4, 4, 4, 4, 4, 4, 4, 4, 4, 4, 0, 5, 0, 0, 17, 0, 0],
	[4, 4, 4, 4, 4, 4, 4, 4, 4, 4, 4, 4, 0, 0, 5, 0, 0, 0, 0, 0],
	[4, 4, 4, 4, 4, 4, 4, 4, 4, 4, 4, 0, 0, 0, 5, 0, 0, 0, 0, 0],
	[4, 4, 4, 4, 4, 4, 4, 4, 4, 4, 0, 0, 0, 0, 5, 5, 5, 0, 5, 5],
	[4, 4, 4, 4, 4, 4, 4, 4, 4, 15, 0, 0, 0, 0, 0, 0, 0, 0, 0, 0],
	[4, 4, 4, 4, 4, 4, 4, 4, 15, 15, 0, 0, 2, 0, 0, 0, 2, 2, 2, 0],
	[4, 4, 4, 4, 4, 4, 4, 15, 15, 0, 0, 0, 0, 0, 0, 0, 0, 0, 0, 0],
	[4, 4, 4, 4, 4, 4, 0, 0, 0, 0, 2, 0, 0, 0, 2, 0, 0, 0, 0, 0],
	[4, 4, 4, 4, 4, 0, 0, 0, 0, 0, 0, 0, 0, 0, 0, 0, 0, 0, 0, 0],
	[4, 4, 4, 4, 0, 0, 0, 0, 2, 0, 0, 0, 2, 0, 0, 0, 2, 0, 0, 0],
	[4, 4, 4, 0, 0, 0, 0, 0, 0, 0, 0, 0, 0, 0, 0, 0, 0, 0, 0, 0],
	[0, 16, 0, 0, 0, 0, 0, 0, 0, 0, 2, 0, 0, 0, 2, 0, 0, 0, 0, 0],
	[16, 18, 16, 0, 0, 0, 0, 0, 0, 0, 0, 0, 0, 0, 0, 0, 0, 0, 0, 0],
	[0, 16, 0, 0, 0, 0, 0, 0, 0, 0, 0, 0, 2, 0, 0, 0, 0, 0, 0, 0]
]